30 15 60
0 0 0 0 0 0 0 0 0 0 0 0 0 0 0 0 0 0 0 0 0 0 0 0 0 0 0 0 0 0 
0 0 0 0 0 0 0 0 0 0 0 0 0 0 0 0 0 0 0 0 0 0 0 0 0 0 0 0 0 0 
0 0 0 0 0 0 0 0 0 0 0 0 0 0 0 0 0 0 0 0 0 0 0 0 0 0 0 0 0 0 
0 0 0 0 0 0 0 0 2 0 0 0 0 2 1 1 2 0 0 0 0 0 0 0 0 0 0 0 0 0 
0 0 0 0 0 0 0 0 1 0 0 0 2 2 0 0 2 2 0 0 0 0 0 0 0 0 0 0 0 0 
0 0 0 0 0 2 1 1 2 0 0 2 2 0 0 0 0 2 2 0 0 0 0 0 3 0 0 0 0 0 
0 0 0 0 0 1 0 0 1 0 0 1 0 0 0 0 0 0 1 0 0 0 0 0 1 0 0 0 0 0 
0 0 0 0 0 2 2 0 2 1 1 2 2 0 0 0 0 2 2 1 1 2 0 2 2 0 0 0 0 0 
0 0 0 0 0 1 0 0 0 0 0 1 0 0 0 0 0 0 1 0 0 1 0 0 1 0 0 0 0 0 
0 0 0 0 0 2 0 0 0 0 0 2 2 0 0 0 0 2 2 0 0 2 1 1 2 0 0 0 0 0 
0 0 0 0 0 0 0 0 0 0 0 0 2 2 0 0 2 2 0 0 0 1 0 0 0 0 0 0 0 0 
0 0 0 0 0 0 0 0 0 0 0 0 0 2 1 1 2 0 0 0 0 2 0 0 0 0 0 0 0 0 
0 0 0 0 0 0 0 0 0 0 0 0 0 0 0 0 0 0 0 0 0 0 0 0 0 0 0 0 0 0 
0 0 0 0 0 0 0 0 0 0 0 0 0 0 0 0 0 0 0 0 0 0 0 0 0 0 0 0 0 0 
0 0 0 0 0 0 0 0 0 0 0 0 0 0 0 0 0 0 0 0 0 0 0 0 0 0 0 0 0 0 
37
8 3
13 3
16 3
12 4
13 4
16 4
17 4
5 5
8 5
11 5
12 5
17 5
18 5
5 7
6 7
8 7
11 7
12 7
17 7
18 7
21 7
23 7
24 7
5 9
11 9
12 9
17 9
18 9
21 9
24 9
12 10
13 10
16 10
17 10
13 11
16 11
21 11
24 5
