30 15 60
2 1 1 1 1 1 1 2 1 1 1 1 1 1 2 2 1 1 1 1 1 1 2 1 1 1 1 1 1 2 
1 0 0 0 0 0 0 1 0 0 0 0 0 0 2 2 0 0 0 0 0 0 1 0 0 0 0 0 0 1 
2 1 1 1 1 1 1 2 1 1 1 1 1 1 2 2 1 1 1 1 1 1 3 1 1 1 1 1 1 2 
1 0 0 0 0 0 0 0 0 0 0 0 0 0 2 2 0 0 0 0 0 0 0 0 0 0 0 0 0 1 
2 2 0 0 0 0 0 0 0 0 0 0 0 0 2 2 0 0 0 0 0 0 0 0 0 0 0 0 2 2 
0 2 2 0 0 0 0 0 0 0 0 0 0 0 2 2 0 0 0 0 0 0 0 0 0 0 0 2 2 0 
0 0 2 1 4 0 0 0 0 0 0 0 0 0 2 2 0 0 0 0 0 0 0 0 0 2 1 2 0 0 
2 0 0 0 2 1 1 2 0 0 0 0 0 0 2 2 0 0 0 0 0 0 2 1 1 2 0 0 0 2 
1 0 0 0 0 0 0 2 1 2 0 0 0 0 2 2 0 0 0 0 2 1 2 0 0 0 0 0 0 1 
1 0 0 0 0 0 0 0 0 2 1 2 0 0 2 2 0 0 2 1 2 0 0 0 0 0 0 0 0 1 
1 0 0 0 0 0 0 0 0 0 0 2 1 1 2 2 1 1 2 0 0 0 0 0 0 0 0 0 0 1 
1 0 0 0 0 0 0 0 0 0 0 0 0 0 2 2 0 0 0 0 0 0 0 0 0 0 0 0 0 1 
2 1 1 1 1 1 1 2 1 1 1 1 1 1 2 2 1 1 1 1 1 1 2 1 1 1 1 1 1 2 
1 0 0 0 0 0 0 1 0 0 0 0 0 0 2 2 0 0 0 0 0 0 1 0 0 0 0 0 0 1 
2 1 1 1 1 1 1 2 1 1 1 1 1 1 2 2 1 1 1 1 1 1 2 1 1 1 1 1 1 2 
72
0 0 SE
0 7 SEW
0 14 SEW
0 15 SEW
0 22 SEW
0 29 SW
1 14 NSE
1 15 NSW
2 0 NSE
2 7 NSEW
2 14 NSEW
2 15 NSEW
2 29 NSW
3 14 NSE
3 15 NSW
4 0 NSE
4 1 SEW
4 14 NSEW
4 15 NSEW
4 28 SEW
4 29 NSW
5 1 NE
5 2 SEW
5 14 NSEW
5 15 NSEW
5 27 SEW
5 28 NW
6 2 NE
6 4 SEW
6 14 NSEW
6 15 NSEW
6 25 SEW
6 27 NW
7 0 NSE
7 4 NEW
7 7 NSEW
7 14 NSEW
7 15 NSEW
7 22 NSEW
7 25 NEW
7 29 NSW
8 7 NSE
8 9 SEW
8 14 NSEW
8 15 NSEW
8 20 SEW
8 22 NSW
9 9 NE
9 11 SEW
9 14 NSEW
9 15 NSEW
9 18 SEW
9 20 NW
10 11 NE
10 14 NSEW
10 15 NSEW
10 18 NW
11 14 NSE
11 15 NSW
12 0 NSE
12 7 NSEW
12 14 NSEW
12 15 NSEW
12 22 NSEW
12 29 NSW
13 14 NSE
13 15 NSW
14 0 NE
14 7 NEW
14 14 NEW
14 15 NEW
14 22 NEW
14 29 NW
2 22
