30 15 60
2 1 1 1 1 1 1 2 1 1 1 1 1 1 2 2 1 1 1 1 1 1 2 1 1 1 1 1 1 2 
1 0 0 0 0 0 0 1 0 0 0 0 0 0 2 2 0 0 0 0 0 0 1 0 0 0 0 0 0 1 
2 1 1 1 1 1 1 2 1 1 1 1 1 1 2 2 1 1 1 1 1 1 3 1 1 1 1 1 1 2 
1 0 0 0 0 0 0 0 0 0 0 0 0 0 2 2 0 0 0 0 0 0 0 0 0 0 0 0 0 1 
2 2 0 0 0 0 0 0 0 0 0 0 0 0 2 2 0 0 0 0 0 0 0 0 0 0 0 0 2 2 
0 2 2 0 0 0 0 0 0 0 0 0 0 0 2 2 0 0 0 0 0 0 0 0 0 0 0 2 2 0 
0 0 2 1 4 0 0 0 0 0 0 0 0 0 2 2 0 0 0 0 0 0 0 0 0 2 1 2 0 0 
2 0 0 0 2 1 1 2 0 0 0 0 0 0 2 2 0 0 0 0 0 0 2 1 1 2 0 0 0 2 
1 0 0 0 0 0 0 2 1 2 0 0 0 0 2 2 0 0 0 0 2 1 2 0 0 0 0 0 0 1 
1 0 0 0 0 0 0 0 0 2 1 2 0 0 2 2 0 0 2 1 2 0 0 0 0 0 0 0 0 1 
1 0 0 0 0 0 0 0 0 0 0 2 1 1 2 2 1 1 2 0 0 0 0 0 0 0 0 0 0 1 
1 0 0 0 0 0 0 0 0 0 0 0 0 0 2 2 0 0 0 0 0 0 0 0 0 0 0 0 0 1 
2 1 1 1 1 1 1 2 1 1 1 1 1 1 2 2 1 1 1 1 1 1 2 1 1 1 1 1 1 2 
1 0 0 0 0 0 0 1 0 0 0 0 0 0 2 2 0 0 0 0 0 0 1 0 0 0 0 0 0 1 
2 1 1 1 1 1 1 2 1 1 1 1 1 1 2 2 1 1 1 1 1 1 2 1 1 1 1 1 1 2 
72
0 0 SE
0 7 SEW
0 14 SEW
0 15 SEW
0 22 SEW
0 29 SW
1 14 NSE
1 15 NSW
2 0 NSE
2 7 NEW
2 14 NSEW
2 15 NSEW
2 29 NSW
3 14 NSE
3 15 NSW
4 0 NE
4 1 SW
4 14 NSE
4 15 NSW
4 28 SE
4 29 NW
5 1 NE
5 2 SW
5 14 NSE
5 15 NSW
5 27 SE
5 28 NW
6 2 NE
6 4 SW
6 14 NSE
6 15 NSW
6 25 SE
6 27 NW
7 0 S
7 4 NE
7 7 SW
7 14 NSE
7 15 NSW
7 22 SE
7 25 NW
7 29 S
8 7 NE
8 9 SW
8 14 NSE
8 15 NSW
8 20 SE
8 22 NW
9 9 NE
9 11 SW
9 14 NSE
9 15 NSW
9 18 SE
9 20 NW
10 11 NE
10 14 NSEW
10 15 NSEW
10 18 NW
11 14 NSE
11 15 NSW
12 0 NSE
12 7 SEW
12 14 NSEW
12 15 NSEW
12 22 SEW
12 29 NSW
13 14 NSE
13 15 NSW
14 0 NE
14 7 NEW
14 14 NEW
14 15 NEW
14 22 NEW
14 29 NW
2 22
